########################################
#..........#####.......................#
#..........#...#.......................#
#..........#...#.......................#
#..........#####.......................#
#......................................#
#.......####...........................#
#.......#..#...........................#
#.......#..#........######.............#
#.......####........#.....#............#
#...................#.....#............#
#...................######.............#
#......................................#
#..###.................................#
#..#.#.................................#
#..###..........####...................#
#...............#..#...................#
#...............#..#...................#
#...............####...................#
#......................................#
#........#####.........................#
#........#...#.........................#
#........#####.........................#
#......................................#
########################################
