######################################## 
#..........#####.......................#
#..........#...#.......................#
#..........#...#.......................#                                          
#..........#####.......................#                                          
#......................................#                                          
#.......####...........................#               ###########################  
#.......#..#...........................#               #.........................#         
#.......#..#........######.............#               #.........................#        
#.......####........#.....#............#               #.........................#                
#...................#.>...#............#################.........................#                
#...................######.......................................................#                
#......................................#################.........................#                
#..###.................................#               #.........................#                
#..#.#.................................#               ###########################                
#..###..........####...................#                                                          
#...............#..#...................#                                                          
#...............#..#...................#                                                          
#...............####...................#                                                          
#......................................#                                                          
#........#####.........................#                                                          
#........#...#.........................#                                                          
#........#####.........................#                                                          
#......................................#                                                          
########################################                                                                                                                  
                                                                                                                                                          
