############################
#..........................#
#..........................#
#..........................#
#..........................#
#..........................#
#..........................#
#..........................#
#..........................#
#..........................#
#......................<...#
#..........................#
#..........................#               
#..........................##############  
#...................................... ###
#..........................#############..#      
#..........................#           #..#
############..##############           #..#     
           #..#                        #..#    
           #..##########################..#
           #..............................#
           #..######################## ####  
           #..#                      #.#   
           #..########################.#
           #...........................#
           #..##########################
  ##########....#		      
  #.............#		      
  #.............#
  #.............#
  #.............#
  #.............#
  ###############

